6 12 12 12 12 12 12 12 12 12 12 12 12 12 12 8
13 15 15 15 15 15 15 15 15 15 15 15 15 15 15 15
13 15 15 15 15 15 15 15 15 15 15 15 15 15 15 15
13 15 15 15 15 15 15 15 15 15 15 15 15 15 15 15
13 15 15 15 15 15 15 15 15 15 15 15 15 15 15 15
13 15 15 15 15 15 15 15 15 15 15 15 15 15 15 15
13 15 15 15 15 15 15 15 15 15 15 15 15 15 15 15
13 15 15 15 15 15 15 15 15 15 15 15 15 15 15 15
13 15 15 15 15 15 15 15 15 15 15 15 15 15 15 15
13 15 15 15 15 15 15 15 15 15 15 15 15 15 15 15
13 15 15 15 15 15 15 15 15 15 15 15 15 15 15 15
10 15 15 15 15 15 15 15 15 15 15 15 15 15 15 15
