6 3 7 15 6 12 12 12 12 12 12 12 12 12 12 9
1 0 15 12 2 15 6 12 12 12 12 12 7 15 15 13
13 10 5 15 13 15 13 15 6 12 12 7 4 12 12 2
13 8 15 15 13 10 5 15 13 15 15 13 10 7 15 13
13 4 12 12 2 15 15 15 13 15 15 13 15 13 15 13
1 3 12 9 4 12 12 12 5 15 15 13 15 13 15 13
13 13 6 12 12 12 12 12 12 7 15 13 6 0 3 5
13 13 13 6 12 12 12 7 15 13 15 13 13 12 1 7
13 13 11 13 6 7 8 13 15 13 15 13 13 12 13 11
4 15 12 5 4 15 5 13 15 13 15 13 13 12 4 7
6 13 15 15 6 0 7 4 12 0 12 5 13 15 15 13
10 0 12 12 5 15 4 12 12 12 12 12 5 10 12 5
