15 15 15 15 15 15 15 15 15 15 15 15 15 15 15 8
15 15 15 15 15 15 15 15 15 15 15 15 15 15 15 13
15 15 15 15 15 15 15 15 15 15 15 15 15 15 15 13
15 6 12 12 12 12 12 12 12 7 15 15 15 15 15 13
15 13 15 15 15 15 15 15 15 13 15 15 15 15 15 13
15 13 15 15 15 15 15 15 15 13 15 15 15 15 15 13
15 13 15 15 15 15 15 15 15 13 15 15 15 15 15 13
15 13 15 15 15 15 15 15 15 4 12 12 12 12 12 5
15 4 12 7 15 15 15 15 15 15 15 15 15 15 15 15
15 15 15 13 15 15 15 15 15 15 15 15 15 15 15 15
15 15 15 13 15 15 15 15 15 15 15 15 15 15 15 15
10 12 12 5 15 15 15 15 15 15 15 15 15 15 15 15