12 15 13 15 15 15 15 15 15 15 15 15 15 15 15 8
15 15 15 15 15 15 15 15 15 15 15 15 15 15 15 13
1 15 3 15 2 15 0 15 15 15 15 15 15 15 15 13
15 15 15 15 15 15 15 15 15 15 15 15 15 15 15 13
6 15 7 15 5 15 4 15 15 15 15 15 15 15 15 13
15 15 15 15 15 15 15 15 15 15 15 15 15 15 15 13
10 15 8 15 9 15 11 15 15 15 15 15 15 15 15 13
15 15 15 15 15 15 15 15 15 15 15 15 15 15 15 13
15 15 15 15 15 15 15 15 15 15 15 15 15 15 15 13
15 15 15 15 15 15 15 15 15 15 15 15 15 15 15 13
15 15 15 15 15 15 15 15 15 15 15 15 15 15 15 13
10 12 12 12 12 12 12 12 12 12 12 12 12 12 12 5