0 0 0 0 0 0 0 0 0 0 0 0 0 0 0 8
0 0 0 0 0 0 0 0 0 0 0 0 0 0 0 13
0 0 0 0 0 0 0 0 0 0 0 0 0 0 0 13
0 6 12 12 12 12 12 12 12 7 0 0 0 0 0 13
0 13 0 0 0 0 0 0 0 13 0 0 0 0 0 13
0 13 0 0 0 0 0 0 0 13 0 0 0 0 0 13
0 13 0 0 0 0 0 0 0 13 0 0 0 0 0 13
0 13 0 0 0 0 0 0 0 4 12 12 12 12 12 5
0 4 12 7 0 0 0 0 0 0 0 0 0 0 0 0
0 0 0 13 0 0 0 0 0 0 0 0 0 0 0 0
0 0 0 13 0 0 0 0 0 0 0 0 0 0 0 0
10 12 12 5 0 0 0 0 0 0 0 0 0 0 0 0